15 15
11 12 13 9 8 10 14 9 10 10 14 9 12 11 12 
9 6 5 5 7 9 12 5 9 12 9 6 3 8 4 
3 10 4 5 9 6 5 5 5 1 6 9 8 6 7 
9 10 4 3 6 13 3 0 2 6 9 6 3 8 12 
5 9 2 10 10 0 8 2 10 12 5 9 8 6 5 
5 5 9 12 13 1 4 9 12 5 5 3 6 11 4 
5 5 5 5 5 3 6 23 5 7 3 10 10 10 4 
5 3 6 5 1 12 9 10 2 10 10 12 9 10 4 
1 8 12 5 3 4 3 10 8 10 12 5 5 11 4 
1 2 4 3 14 1 8 12 5 9 2 6 1 12 5 
5 9 2 10 12 3 2 4 5 5 9 12 3 4 7 
5 5 9 10 2 8 12 3 6 1 2 2 12 3 12 
5 5 5 9 8 6 3 10 10 6 9 12 3 12 5 
5 3 6 5 3 10 10 8 12 9 6 3 12 3 4 
3 10 10 6 11 10 10 6 3 2 10 10 2 10 6 
