15 15
9 10 8 10 10 12 9 12 9 8 14 9 10 10 12 
3 12 3 12 9 2 6 3 6 3 10 2 8 12 7 
9 6 13 5 5 9 12 9 12 11 10 10 4 3 12 
5 9 6 5 3 6 3 6 3 10 10 12 5 9 6 
5 3 12 5 9 10 12 9 10 14 9 6 7 3 12 
5 11 4 5 5 11 6 3 8 12 3 8 8 12 5 
1 10 6 5 1 10 10 8 6 5 9 6 5 7 5 
5 9 10 4 5 11 10 6 9 6 5 13 3 8 6 
5 7 9 6 7 9 10 12 5 11 2 2 14 3 12 
3 10 6 9 12 3 12 3 6 9 10 12 9 12 5 
9 10 10 6 3 10 2 8 12 5 13 5 5 5 5 
1 10 10 10 10 8 12 23 5 5 3 4 5 3 6 
3 8 10 10 12 7 3 10 6 1 12 3 6 11 12 
9 6 11 12 3 12 9 10 8 6 7 9 14 9 6 
3 10 10 6 11 2 6 11 2 10 10 2 10 2 14 
