15 15
9 10 10 8 8 14 9 14 9 12 9 8 12 9 12 
1 8 12 5 1 10 4 9 6 3 6 5 5 5 5 
5 1 6 5 3 14 5 5 11 10 12 5 3 6 5 
5 7 9 2 10 14 5 1 8 10 4 1 12 13 5 
3 10 6 9 8 10 2 6 3 10 6 1 0 6 5 
9 8 12 1 6 13 9 12 9 8 8 2 6 9 4 
1 6 1 6 9 4 1 2 2 6 5 9 10 0 6 
5 13 1 12 3 4 3 10 14 9 4 5 13 5 13 
3 4 5 1 12 5 11 10 8 2 6 5 1 2 4 
9 2 4 1 6 3 8 10 2 12 9 6 5 9 6 
5 9 4 7 9 8 2 8 10 6 5 9 4 3 14 
5 3 4 9 6 7 29 1 10 10 6 3 2 10 12 
1 8 6 5 9 12 1 6 11 10 10 12 9 8 4 
5 7 9 6 5 5 3 10 10 10 12 5 5 1 4 
3 10 2 10 6 3 10 10 10 10 6 3 6 3 6 
