15 15
9 12 13 9 10 10 8 12 9 14 9 12 9 10 12 
5 3 6 3 14 9 6 3 6 9 6 3 2 14 5 
5 9 10 12 9 4 9 10 8 4 9 12 11 8 6 
3 4 9 6 5 7 5 9 6 3 6 5 9 2 12 
13 5 3 12 1 10 6 1 10 14 9 6 5 9 6 
3 6 9 4 3 12 9 4 9 12 3 8 6 3 12 
9 12 5 5 11 4 7 1 6 3 12 5 9 12 5 
5 3 6 1 8 6 9 6 27 12 5 3 6 5 5 
3 12 9 6 5 9 6 9 10 6 3 12 11 6 5 
9 6 5 13 5 5 13 3 8 8 12 3 12 9 4 
5 11 4 3 6 5 5 11 6 5 1 10 6 7 5 
3 12 5 9 10 4 3 8 14 5 5 9 10 10 4 
9 6 7 3 14 1 8 6 9 6 5 3 10 12 5 
5 9 10 8 10 6 1 12 3 12 1 12 9 6 5 
3 6 11 6 11 10 6 3 10 6 7 3 6 11 6 
